Label,Expected,TP,FP,FN,Recall,Precision,F-measure,Training Samples
cad.mention.before_dct,170,164,34,6,0.9647058823529412,0.8282828282828283,0.8913043478260869,254
cad.mention.during_dct,175,164,34,11,0.9371428571428572,0.8282828282828283,0.8793565683646112,255
cad.mention.after_dct,171,164,34,7,0.9590643274853801,0.8282828282828283,0.8888888888888888,253
cad.event.before_dct,129,113,50,16,0.875968992248062,0.6932515337423313,0.7739726027397261,222
cad.event.during_dct,9,1,0,8,0.1111111111111111,1.0,0.19999999999999998,19
cad.event.after_dct,1,0,0,1,0.0,0,0,2
cad.test.before_dct,53,40,25,13,0.7547169811320755,0.6153846153846154,0.6779661016949153,66
cad.test.during_dct,6,2,0,4,0.3333333333333333,1.0,0.5,13
cad.test.after_dct,0,0,0,0,0,0,0,0
cad.symptom.before_dct,41,17,21,24,0.4146341463414634,0.4473684210526316,0.430379746835443,52
cad.symptom.during_dct,26,0,6,26,0.0,0.0,0,23
cad.symptom.after_dct,3,0,0,3,0.0,0,0,3
diabetes.mention.before_dct,354,347,28,7,0.980225988700565,0.9253333333333333,0.9519890260631001,512
diabetes.mention.during_dct,356,347,28,9,0.9747191011235955,0.9253333333333333,0.9493844049247607,518
diabetes.mention.after_dct,355,347,28,8,0.9774647887323944,0.9253333333333333,0.9506849315068493,512
diabetes.a1c.before_dct,71,33,22,38,0.4647887323943662,0.6,0.5238095238095237,69
diabetes.a1c.during_dct,11,0,1,11,0.0,0.0,0,19
diabetes.a1c.after_dct,0,0,0,0,0,0,0,0
diabetes.glucose.before_dct,18,2,9,16,0.1111111111111111,0.18181818181818182,0.13793103448275862,14
diabetes.glucose.during_dct,15,0,0,15,0.0,0,0,7
diabetes.glucose.after_dct,0,0,0,0,0,0,0,0
obese.mention.before_dct,79,76,9,3,0.9620253164556962,0.8941176470588236,0.926829268292683,132
obese.mention.during_dct,87,76,9,11,0.8735632183908046,0.8941176470588236,0.8837209302325582,145
obese.mention.after_dct,79,76,9,3,0.9620253164556962,0.8941176470588236,0.926829268292683,132
obese.bmi.before_dct,2,0,0,2,0.0,0,0,2
obese.bmi.during_dct,13,1,3,12,0.07692307692307693,0.25,0.11764705882352941,11
obese.bmi.after_dct,2,0,0,2,0.0,0,0,1
hyperlipidemia.mention.before_dct,237,220,10,17,0.9282700421940928,0.9565217391304348,0.9421841541755889,331
hyperlipidemia.mention.during_dct,237,220,10,17,0.9282700421940928,0.9565217391304348,0.9421841541755889,331
hyperlipidemia.mention.after_dct,237,220,10,17,0.9282700421940928,0.9565217391304348,0.9421841541755889,331
hyperlipidemia.high_ldl.before_dct,26,1,2,25,0.038461538461538464,0.3333333333333333,0.06896551724137931,16
hyperlipidemia.high_ldl.during_dct,3,0,0,3,0.0,0,0,9
hyperlipidemia.high_ldl.after_dct,0,0,0,0,0,0,0,0
hyperlipidemia.high_chol..before_dct,9,0,0,9,0.0,0,0,7
hyperlipidemia.high_chol..during_dct,2,0,0,2,0.0,0,0,1
hyperlipidemia.high_chol..after_dct,0,0,0,0,0,0,0,0
hypertension.mention.before_dct,365,360,14,5,0.9863013698630136,0.9625668449197861,0.9742895805142084,514
hypertension.mention.during_dct,367,360,14,7,0.9809264305177112,0.9625668449197861,0.97165991902834,513
hypertension.mention.after_dct,366,360,14,6,0.9836065573770492,0.9625668449197861,0.9729729729729729,511
hypertension.high_bp.before_dct,20,1,4,19,0.05,0.2,0.08000000000000002,39
hypertension.high_bp.during_dct,175,129,133,46,0.7371428571428571,0.49236641221374045,0.5903890160183066,320
hypertension.high_bp.after_dct,0,0,0,0,0,0,0,0
medication.ace_inhibitor.before_dct,209,187,28,22,0.8947368421052632,0.8697674418604651,0.8820754716981132,320
medication.ace_inhibitor.during_dct,199,187,28,12,0.9396984924623115,0.8697674418604651,0.9033816425120772,312
medication.ace_inhibitor.after_dct,204,187,28,17,0.9166666666666666,0.8697674418604651,0.8926014319809069,316
medication.anti_diabetes.before_dct,0,0,0,0,0,0,0,1
medication.anti_diabetes.during_dct,0,0,0,0,0,0,0,1
medication.anti_diabetes.after_dct,0,0,0,0,0,0,0,1
medication.arb.before_dct,67,52,6,15,0.7761194029850746,0.896551724137931,0.8320000000000001,96
medication.arb.during_dct,64,52,6,12,0.8125,0.896551724137931,0.8524590163934426,92
medication.arb.after_dct,62,52,6,10,0.8387096774193549,0.896551724137931,0.8666666666666666,95
medication.aspirin.before_dct,263,253,33,10,0.9619771863117871,0.8846153846153846,0.9216757741347906,421
medication.aspirin.during_dct,273,254,34,19,0.9304029304029304,0.8819444444444444,0.9055258467023173,428
medication.aspirin.after_dct,262,253,33,9,0.9656488549618321,0.8846153846153846,0.9233576642335767,422
medication.beta_blocker.before_dct,276,261,36,15,0.9456521739130435,0.8787878787878788,0.9109947643979057,462
medication.beta_blocker.during_dct,281,261,37,20,0.9288256227758007,0.8758389261744967,0.9015544041450777,464
medication.beta_blocker.after_dct,278,262,36,16,0.9424460431654677,0.8791946308724832,0.9097222222222223,465
medication.calcium_channel_blocker.before_dct,129,116,18,13,0.8992248062015504,0.8656716417910447,0.8821292775665398,185
medication.calcium_channel_blocker.during_dct,128,116,18,12,0.90625,0.8656716417910447,0.8854961832061069,177
medication.calcium_channel_blocker.after_dct,128,116,18,12,0.90625,0.8656716417910447,0.8854961832061069,180
medication.diuretic.before_dct,80,65,25,15,0.8125,0.7222222222222222,0.7647058823529411,112
medication.diuretic.during_dct,70,64,22,6,0.9142857142857143,0.7441860465116279,0.8205128205128205,98
medication.diuretic.after_dct,72,64,22,8,0.8888888888888888,0.7441860465116279,0.8101265822784809,104
medication.dpp4_inhibitors.before_dct,2,0,0,2,0.0,0,0,1
medication.dpp4_inhibitors.during_dct,2,0,0,2,0.0,0,0,0
medication.dpp4_inhibitors.after_dct,2,0,0,2,0.0,0,0,0
medication.ezetimibe.before_dct,11,6,0,5,0.5454545454545454,1.0,0.7058823529411764,12
medication.ezetimibe.during_dct,11,6,0,5,0.5454545454545454,1.0,0.7058823529411764,12
medication.ezetimibe.after_dct,14,6,0,8,0.42857142857142855,1.0,0.6,12
medication.fibrate.before_dct,31,25,5,6,0.8064516129032258,0.8333333333333334,0.819672131147541,22
medication.fibrate.during_dct,29,25,5,4,0.8620689655172413,0.8333333333333334,0.847457627118644,20
medication.fibrate.after_dct,30,25,5,5,0.8333333333333334,0.8333333333333334,0.8333333333333334,22
medication.insulin.before_dct,132,125,33,7,0.946969696969697,0.7911392405063291,0.8620689655172413,203
medication.insulin.during_dct,131,125,33,6,0.9541984732824428,0.7911392405063291,0.8650519031141869,215
medication.insulin.after_dct,132,125,33,7,0.946969696969697,0.7911392405063291,0.8620689655172413,211
medication.metformin.before_dct,125,111,28,14,0.888,0.7985611510791367,0.8409090909090909,185
medication.metformin.during_dct,113,111,28,2,0.9823008849557522,0.7985611510791367,0.880952380952381,174
medication.metformin.after_dct,118,111,28,7,0.940677966101695,0.7985611510791367,0.8638132295719845,177
medication.niacin.before_dct,9,0,0,9,0.0,0,0,7
medication.niacin.during_dct,7,0,0,7,0.0,0,0,6
medication.niacin.after_dct,9,0,0,9,0.0,0,0,7
medication.nitrate.before_dct,91,74,28,17,0.8131868131868132,0.7254901960784313,0.766839378238342,110
medication.nitrate.during_dct,95,81,26,14,0.8526315789473684,0.7570093457943925,0.8019801980198019,118
medication.nitrate.after_dct,85,73,24,12,0.8588235294117647,0.7525773195876289,0.8021978021978021,90
medication.statin.before_dct,274,260,27,14,0.948905109489051,0.9059233449477352,0.9269162210338681,426
medication.statin.during_dct,266,260,27,6,0.9774436090225563,0.9059233449477352,0.9403254972875226,418
medication.statin.after_dct,277,260,27,17,0.9386281588447654,0.9059233449477352,0.9219858156028368,430
medication.sulfonylureas.before_dct,98,92,8,6,0.9387755102040817,0.92,0.9292929292929293,156
medication.sulfonylureas.during_dct,94,92,8,2,0.9787234042553191,0.92,0.9484536082474226,152
medication.sulfonylureas.after_dct,96,92,8,4,0.9583333333333334,0.92,0.9387755102040817,154
medication.thiazolidinedione.before_dct,22,18,5,4,0.8181818181818182,0.782608695652174,0.8,41
medication.thiazolidinedione.during_dct,19,18,5,1,0.9473684210526315,0.782608695652174,0.8571428571428571,39
medication.thiazolidinedione.after_dct,20,18,5,2,0.9,0.782608695652174,0.8372093023255814,38
medication.thienopyridine.before_dct,97,87,14,10,0.8969072164948454,0.8613861386138614,0.8787878787878788,94
medication.thienopyridine.during_dct,95,87,14,8,0.9157894736842105,0.8613861386138614,0.8877551020408163,93
medication.thienopyridine.after_dct,92,87,14,5,0.9456521739130435,0.8613861386138614,0.9015544041450778,94
smoker.current,33,11,4,22,0.3333333333333333,0.7333333333333333,0.45833333333333326,57
smoker.ever,3,0,0,3,0.0,0,0,9
smoker.never,120,96,36,24,0.8,0.7272727272727273,0.761904761904762,183
smoker.past,113,97,65,16,0.8584070796460177,0.5987654320987654,0.7054545454545453,148
smoker.unknown,245,140,65,105,0.5714285714285714,0.6829268292682927,0.6222222222222223,0
family_hist.present,19,2,4,17,0.10526315789473684,0.3333333333333333,0.16,21
family_hist.not_present,495,491,17,4,0.9919191919191919,0.9665354330708661,0.979062811565304,0
